ALD	= "countries/High Elf.txt"
ANQ	= "countries/Wood Elf.txt"
BLM	= "countries/Argonian.txt"
CYR	= "countries/Imperial.txt"
DRS	= "countries/Dark Elf.txt"
FLK = "countries/Nord.txt"
HAM = "countries/Redguard.txt"
HJA	= "countries/Nord.txt"
HLA	= "countries/Dark Elf.txt"
HRK = "countries/Breton.txt"
IDR	= "countries/Dark Elf.txt"
JLF	= "countries/Nord.txt"
KML = "countries/Nord.txt"
KPT = "countries/Nord.txt"
PEL	= "countries/Wood Elf.txt"
PLE	= "countries/Nord.txt"
PYD = "countries/High Elf.txt"
RED	= "countries/Dark Elf.txt"
SKY	= "countries/Nord.txt"
TEL = "countries/Dark Elf.txt"
TGM	= "countries/Nord.txt"
TSA = "countries/Nord.txt"
VAL	= "countries/Wood Elf.txt"
VLK	= "countries/Nord.txt"
WIN	= "countries/Nord.txt"
WTR	= "countries/Nord.txt"
RIF	= "countries/Nord.txt"